##################################
#................................#
#.......#........................#
#.......#........................#
#.......###......................#
#.........#......................#
#.........#####################..#
#.............................#..#
#.............................#..#
#.............................#..#
##################################