##################################
#...............~~~~~~~..........#
#.......#.......~~~~~~~~~........#
#.......#.........~~~~~..........#
#.......###......................#
#.........#......................#
#.........#####################..#
#..~~~~~~~....................#..#
#..~~~~~~~....................#..#
#.............................#..#
##################################